+,+,+,+,+,+,+,+,+,+,+,+,+,+,+,+,+,+,+,+,+,+,+,+,+,+,+,+,+,+,+,+,+,+,+,+,+,+,+,+,+,+,+,+,+,+,+,+,+,+,+,+,+,+,+,+,+,+,+,+,+,+,+,+,+,+,+,+,+,+,+,+,+,+,+,+,+,+,+,+,+,+,+,+,+,+,+,+,+
+,+,+,+,+,+,+,+,+,+,+,+,+,+,+,+,+,+,+,+,+,+,+,+,+,+,+,+,+,+,+,+,+,+,+,+,+,+,+,+,+,+,+,+,+,+,+,+,+,+,+,+,+,+,+,+,+,+,+,+,+,+,+,+,+,+,+,+,+,+,+,+,+,+,+,+,+,+,+,+,+,+,+,+,+,+,+,+,+
+,+, , , , , , , , , , , ,+, , , ,+, , , , , , , ,+, , , ,+, , , , , , , , , , , , , , , , , , , , , , , ,+, , , ,+, , , , , ,+, , , , , ,+, ,+, , , , , , , , , , , , , , , ,+,+
+,+, ,+, ,+,+,+,+,+, ,+,+,+, ,+, ,+, ,+,+,+, ,+,+,+, ,+, ,+, ,+,+,+,+,+,+,+,+,+,+,+,+,+, ,+,+,+,+,+,+,+, ,+, ,+, ,+, ,+,+,+, ,+, ,+, ,+, ,+, ,+, ,+,+,+,+,+, ,+,+,+,+,+,+,+, ,+,+
+,+, ,+, ,+, , , , , ,+, , , ,+, , , ,+, , , ,+, , , ,+, , , ,+, , , , , , , ,+, , , , , ,+, ,+, , , , , ,+, ,+, , , ,+, , , ,+, ,+, ,+, , , ,+, , , , , ,+, ,+, , , ,+, , , ,+,+
+,+, ,+, ,+,+,+, ,+,+,+, ,+,+,+,+,+,+,+, ,+, ,+, ,+,+,+,+,+,+,+,+,+,+,+, ,+, ,+, ,+,+,+,+,+, ,+, ,+,+,+,+,+, ,+,+,+,+,+, ,+,+,+, ,+, ,+,+,+,+,+,+,+, ,+,+,+, ,+, ,+,+,+, ,+,+,+,+
+,+, ,+, , , ,+, ,+, , , ,+, , , , , , , ,+, ,+, ,+, , , , , , , ,+, , , ,+, ,+, ,+, , , , , , , , , , , ,+, , , , , ,+, , , ,+, ,+, , , , , , , , , ,+, , , ,+, , , ,+, ,+, ,+,+
+,+, ,+,+,+, ,+, ,+, ,+,+,+, ,+,+,+,+,+,+,+, ,+, ,+,+,+,+,+, ,+, ,+, ,+,+,+,+,+, ,+,+,+,+,+,+,+,+,+,+,+, ,+,+,+,+,+, ,+,+,+, ,+,+,+,+,+,+,+,+,+,+,+, ,+, ,+,+,+,+,+, ,+, ,+, ,+,+
+,+, ,+, ,+, ,+, ,+, , , ,+, ,+, , , , , , , ,+, , , ,+, , , ,+, ,+, ,+, , , ,+, ,+, , , , , , , ,+, , , , , , , , , ,+, ,+, , , , , ,+, , , , , ,+, ,+, , , ,+, , , ,+, , , ,+,+
+,+, ,+, ,+, ,+,+,+,+,+, ,+, ,+,+,+,+,+,+,+,+,+,+,+, ,+, ,+,+,+, ,+, ,+, ,+, ,+, ,+, ,+,+,+,+,+, ,+,+,+,+,+,+,+,+,+,+,+, ,+,+,+,+,+, ,+, ,+,+,+, ,+,+,+, ,+, ,+, ,+, ,+,+,+, ,+,+
+,+, ,+, ,+, , , , , ,+, ,+, , , , , , , , , , , ,+, , , ,+, , , ,+, ,+, ,+, , , ,+, ,+, , , ,+, ,+, , , ,+, , , , , , , , , , , ,+, , , ,+, ,+, , , ,+, ,+, ,+, ,+, ,+, , , ,+,+
+,+, ,+, ,+,+,+, ,+,+,+, ,+,+,+,+,+,+,+, ,+,+,+, ,+, ,+,+,+,+,+, ,+, ,+, ,+,+,+, ,+, ,+, ,+, ,+, ,+, ,+, ,+, ,+,+,+,+,+, ,+,+,+,+,+,+,+,+,+, ,+,+,+, ,+,+,+, ,+, ,+,+,+, ,+,+,+,+
+,+, , , ,+, , , ,+, , , ,+, , , , , ,+, , , ,+, ,+, ,+, , , ,+, ,+, ,+, , , ,+, ,+, ,+, ,+, ,+, ,+, ,+, ,+, ,+, , , , , ,+, , , , , , , , , , , ,+, ,+, , , ,+, , , , , ,+, ,+,+
+,+,+,+, ,+, ,+,+,+, ,+,+,+, ,+,+,+, ,+,+,+, ,+, ,+, ,+, ,+, ,+, ,+, ,+,+,+, ,+,+,+, ,+, ,+, ,+, ,+, ,+, ,+, ,+, ,+,+,+,+,+, ,+,+,+, ,+, ,+,+,+,+,+, ,+, ,+,+,+, ,+,+,+,+,+, ,+,+
+,+, , , ,+, , , ,+, , , ,+, ,+, ,+, , , ,+, ,+, , , ,+, ,+, ,+, , , , , ,+, , , , , , , ,+, ,+, , , ,+, ,+, ,+, ,+, , , , , ,+, ,+, ,+, ,+, , , ,+, , , ,+, ,+, ,+, , , , , ,+,+
+,+, ,+,+,+,+,+, ,+, ,+,+,+, ,+, ,+,+,+, ,+,+,+, ,+,+,+, ,+, ,+,+,+,+,+, ,+,+,+,+,+,+,+,+,+, ,+,+,+,+,+, ,+, ,+, ,+, ,+,+,+,+,+, ,+, ,+,+,+, ,+, ,+,+,+,+,+, ,+, ,+,+,+,+,+, ,+,+
+,+, , , , , ,+, , , ,+, , , ,+, , , , , , , ,+, , , ,+, ,+, ,+, , , , , ,+, , , , , ,+, , , ,+, , , , , ,+, ,+, ,+, ,+, , , , , ,+, , , ,+, ,+, , , , , , , , , , , , , , , ,+,+
+,+,+,+,+,+, ,+,+,+,+,+, ,+,+,+,+,+,+,+,+,+, ,+, ,+,+,+, ,+, ,+,+,+,+,+,+,+, ,+,+,+, ,+, ,+,+,+, ,+,+,+,+,+, ,+, ,+, ,+,+,+,+,+, ,+,+,+, ,+, ,+,+,+,+,+,+,+,+,+,+,+,+,+,+,+, ,+,+
+,+, , , ,+, , , ,+, ,+, , , , , , , , , ,+, ,+, ,+, , , ,+, , , , , ,+, , , ,+, , , ,+, , , ,+, , , , , ,+, ,+, , , , , ,+, , , ,+, , , ,+, , , , , ,+, , , , , , , ,+, , , ,+,+
+,+, ,+, ,+,+,+, ,+, ,+,+,+,+,+,+,+,+,+, ,+, ,+,+,+, ,+,+,+,+,+,+,+, ,+, ,+,+,+, ,+,+,+,+,+,+,+,+,+,+,+, ,+,+,+,+,+,+,+, ,+, ,+,+,+, ,+, ,+, ,+,+,+,+,+, ,+,+,+,+,+, ,+,+,+,+,+,+
+,+, ,+, ,+, , , ,+, , , , , ,+, , , ,+, ,+, , , , , ,+, , , , , ,+, , , ,+, , , ,+, , , , , ,+, , , ,+, , , , , ,+, , , , , ,+, , , ,+, ,+, ,+, , , ,+, ,+, , , ,+, , , , , ,+,+
+,+, ,+,+,+, ,+,+,+, ,+,+,+, ,+,+,+, ,+, ,+,+,+,+,+,+,+, ,+,+,+,+,+,+,+,+,+, ,+,+,+,+,+, ,+, ,+, ,+, ,+,+,+, ,+, ,+,+,+,+,+,+,+, ,+,+,+,+,+, ,+, ,+, ,+, ,+,+,+, ,+,+,+,+,+, ,+,+
+,+, ,+, , , ,+, , , , , ,+, , , ,+, ,+, ,+, , , , , , , ,+, , , , , , , ,+, , , , , ,+, ,+, , , ,+, , , ,+, ,+, , , ,+, , , ,+, , , , , , , ,+, ,+, , , , , , , ,+, , , ,+, ,+,+
+,+, ,+, ,+,+,+,+,+,+,+, ,+,+,+, ,+, ,+, ,+,+,+,+,+,+,+, ,+, ,+,+,+,+,+, ,+,+,+,+,+, ,+, ,+,+,+,+,+,+,+, ,+, ,+,+,+, ,+, ,+, ,+,+,+,+,+,+,+, ,+, ,+,+,+,+,+,+,+, ,+, ,+,+,+, ,+,+
+,+, ,+, , , ,+, , , , , ,+, , , ,+, ,+, , , , , , , ,+, , , ,+, , , ,+, , , ,+, , , ,+, , , ,+, , , ,+, ,+, , , ,+, , , ,+, , , ,+, , , ,+, ,+, ,+, , , ,+, , , , , ,+, , , ,+,+
+,+, ,+,+,+, ,+, ,+,+,+,+,+, ,+,+,+, ,+,+,+,+,+,+,+, ,+,+,+,+,+, ,+, ,+, ,+, ,+, ,+,+,+,+,+, ,+, ,+, ,+, ,+,+,+,+,+,+,+,+,+,+,+, ,+, ,+, ,+, ,+, ,+, ,+, ,+,+,+,+,+, ,+, ,+, , ,E
+,+, ,+, , , ,+, ,+, ,+, , , ,+, , , , , ,+, , , ,+, , , , , ,+, ,+, , , ,+, ,+, ,+, , , , , ,+, ,+, , , , , ,+, , , , , , , ,+, ,+, ,+, ,+, ,+, ,+, ,+, , , ,+, , , ,+, ,+, ,+,+
+,+, ,+, ,+,+,+, ,+, ,+, ,+,+,+, ,+,+,+, ,+, ,+,+,+,+,+,+,+, ,+, ,+,+,+, ,+,+,+, ,+, ,+,+,+,+,+,+,+,+,+,+,+, ,+, ,+,+,+,+,+, ,+, ,+, ,+, ,+,+,+, ,+, ,+,+,+, ,+,+,+,+,+, ,+,+,+,+
+,+, ,+, ,+, , , ,+, , , , , , , ,+, , , , , ,+, , , , , ,+, ,+, ,+, , , ,+, , , ,+, , , , , , , ,+, , , ,+, ,+, , , ,+, , , , , ,+, ,+, , , , , ,+, ,+, ,+, , , , , ,+, , , ,+,+
+,+, ,+, ,+, ,+,+,+,+,+,+,+,+,+, ,+,+,+,+,+,+,+, ,+,+,+, ,+, ,+, ,+,+,+,+,+, ,+,+,+, ,+,+,+,+,+, ,+, ,+, ,+, ,+,+,+, ,+,+,+,+,+,+,+, ,+,+,+,+,+,+,+, ,+, ,+,+,+,+,+, ,+,+,+, ,+,+
+,+, , , ,+, , , , , ,+, ,+, , , ,+, , , , , ,+, ,+, ,+, , , ,+, , , , , ,+, ,+, , , , , , , ,+, ,+, ,+, ,+, , , ,+, , , , , , , , , , , ,+, , , , , ,+, ,+, , , ,+, , , , , ,+,+
+,+, ,+,+,+,+,+,+,+, ,+, ,+, ,+,+,+, ,+,+,+, ,+, ,+, ,+,+,+,+,+, ,+,+,+, ,+, ,+,+,+,+,+,+,+,+,+, ,+, ,+, ,+,+,+, ,+,+,+,+,+,+,+,+,+,+,+,+,+, ,+,+,+,+,+, ,+, ,+, ,+,+,+,+,+, ,+,+
+,+, , , , , , , ,+, ,+, ,+, , , ,+, ,+, , , , , ,+, , , , , ,+, ,+, ,+, , , ,+, , , , , , , ,+, , , ,+, , , ,+, , , , , ,+, , , , , , , ,+, ,+, , , ,+, , , ,+, , , , , , , ,+,+
+,+,+,+,+,+,+,+, ,+, ,+, ,+,+,+, ,+, ,+,+,+,+,+,+,+, ,+,+,+, ,+, ,+, ,+,+,+,+,+, ,+,+,+,+,+, ,+,+,+,+,+,+,+, ,+,+,+,+,+, ,+, ,+,+,+,+,+, ,+, ,+,+,+, ,+, ,+,+,+,+,+,+,+,+,+, ,+,+
+,+, , , ,+, , , , , ,+, , , , , ,+, , , ,+, , , , , ,+, ,+, ,+, ,+, , , , , ,+, , , ,+, , , ,+, , , , , ,+, , , , , ,+, , , ,+, , , , , ,+, , , ,+, , , ,+, , , , , , , ,+, ,+,+
+,+,+,+, ,+, ,+,+,+,+,+,+,+,+,+,+,+,+,+, ,+, ,+,+,+,+,+, ,+, ,+, ,+, ,+,+,+, ,+, ,+, ,+, ,+,+,+, ,+,+,+, ,+, ,+,+,+, ,+,+,+,+,+, ,+,+,+,+,+,+,+, ,+,+,+,+,+, ,+,+,+,+,+, ,+,+,+,+
+,+, , , ,+, , , ,+, , , , , , , , , , , ,+, , , , , , , ,+, , , ,+, , , ,+, , , ,+, ,+, ,+, , , , , ,+, ,+, , , ,+, ,+, , , ,+, ,+, , , , , , , ,+, , , , , ,+, , , ,+, , , ,+,+
+,+, ,+,+,+,+,+, ,+, ,+,+,+,+,+,+,+,+,+,+,+,+,+,+,+,+,+, ,+,+,+,+,+,+,+,+,+,+,+,+,+, ,+, ,+,+,+, ,+, ,+, ,+,+,+, ,+, ,+,+,+, ,+, ,+,+,+,+,+, ,+, ,+, ,+,+,+,+,+,+,+, ,+,+,+, ,+,+
+,+, ,+, , , ,+, ,+, , , , , , , , , , , , , , , ,+, , , ,+, , , , , , , , , , , , , ,+, , , ,+, ,+, ,+, , , ,+, ,+, ,+, , , ,+, , , ,+, , , ,+, ,+, , , , , , , , , ,+, , , ,+,+
+,+, ,+, ,+, ,+, ,+,+,+,+,+,+,+,+,+,+,+,+,+, ,+, ,+,+,+, ,+,+,+, ,+,+,+,+,+,+,+,+,+,+,+,+,+, ,+,+,+, ,+,+,+, ,+, ,+, ,+, ,+,+,+,+,+, ,+, ,+,+,+,+,+,+,+, ,+,+,+,+,+, ,+, ,+,+,+,+
+,+, ,+, ,+, , , , , , , ,+, , , , , , , ,+, ,+, , , ,+, , , , , ,+, , , , , , , , , , , ,+, , , , , ,+, ,+, ,+, ,+, ,+, , , , , ,+, ,+, , , ,+, , , , , ,+, , , ,+, ,+, , , ,+,+
+,+, ,+, ,+,+,+,+,+,+,+,+,+, ,+,+,+,+,+, ,+, ,+,+,+, ,+,+,+, ,+,+,+,+,+, ,+,+,+,+,+,+,+, ,+,+,+,+,+,+,+, ,+, ,+, ,+, ,+, ,+, ,+,+,+, ,+, ,+, ,+, ,+,+,+,+,+, ,+, ,+,+,+,+,+, ,+,+
+,+, , , ,+, , , , , , , , , ,+, , , ,+, ,+, , , ,+, ,+, , , ,+, , , ,+, , , , , ,+, , , , , , , , , , , ,+, ,+, ,+, ,+, ,+, ,+, , , ,+, ,+, , , ,+, , , , , ,+, , , , , ,+, ,+,+
+,+, ,+,+,+, ,+,+,+,+,+,+,+,+,+, ,+, ,+, ,+,+,+, ,+, ,+,+,+,+,+, ,+, ,+,+,+,+,+, ,+, ,+,+,+,+,+,+,+,+,+, ,+, ,+,+,+, ,+,+,+, ,+, ,+,+,+,+,+,+,+, ,+, ,+,+,+,+,+,+,+,+,+, ,+, ,+,+
+,+, , , ,+, ,+, , , , , , , , , ,+, ,+, , , ,+, ,+, , , , , , , ,+, ,+, , , ,+, ,+, ,+, , , , , , , , , ,+, , , ,+, , , ,+, ,+, ,+, , , , , ,+, ,+, ,+, , , ,+, , , ,+, , , ,+,+
+,+,+,+, ,+, ,+, ,+,+,+,+,+,+,+, ,+,+,+,+,+, ,+,+,+,+,+, ,+,+,+,+,+, ,+, ,+, ,+, ,+, ,+,+,+,+,+,+,+,+,+,+,+,+,+, ,+,+,+, ,+, ,+, ,+, ,+, ,+, ,+,+,+, ,+, ,+, ,+, ,+,+,+,+,+, ,+,+
S, , ,+, ,+, ,+, ,+, , , ,+, , , ,+, , , , , ,+, , , ,+, , , ,+, , , ,+, ,+, ,+, ,+, ,+, , , , , ,+, , , , , ,+, ,+, , , ,+, , , ,+, ,+, ,+, , , , , ,+, ,+, , , ,+, , , , , ,+,+
+,+, ,+,+,+, ,+, ,+, ,+, ,+,+,+,+,+, ,+,+,+,+,+, ,+, ,+,+,+,+,+, ,+,+,+, ,+,+,+, ,+, ,+, ,+,+,+, ,+, ,+,+,+, ,+, ,+, ,+,+,+, ,+,+,+,+,+, ,+,+,+,+,+,+,+, ,+,+,+,+,+, ,+,+,+,+,+,+
+,+, , , , , ,+, , , ,+, , , , , , , , , , , , , ,+, , , , , , , ,+, , , , , , , ,+, , , , , ,+, , , , , ,+, , , , , ,+, , , , , , , , , ,+, , , , , , , , , , , , , , , , , ,+,+
+,+,+,+,+,+,+,+,+,+,+,+,+,+,+,+,+,+,+,+,+,+,+,+,+,+,+,+,+,+,+,+,+,+,+,+,+,+,+,+,+,+,+,+,+,+,+,+,+,+,+,+,+,+,+,+,+,+,+,+,+,+,+,+,+,+,+,+,+,+,+,+,+,+,+,+,+,+,+,+,+,+,+,+,+,+,+,+,+
+,+,+,+,+,+,+,+,+,+,+,+,+,+,+,+,+,+,+,+,+,+,+,+,+,+,+,+,+,+,+,+,+,+,+,+,+,+,+,+,+,+,+,+,+,+,+,+,+,+,+,+,+,+,+,+,+,+,+,+,+,+,+,+,+,+,+,+,+,+,+,+,+,+,+,+,+,+,+,+,+,+,+,+,+,+,+,+,+
